June|NNP 10|CD ,|, 1997|CD 

Name|NN Address|NNP City|NNP ,|, ST|NNP Zip|NNP 

Dear|RB Mrs.|NN Name|NN ,|, 

Confidence|NN .|. 
An|DT understanding|NN that|IN ,|, above|IN anything|NN else|RB ,|, success|NN requires|VBZ genuine|JJ effort|NN ,|, a|DT willingness|NN to|TO set|VB challenging|VBG goals|NNS .|. 
Caring|NNP about|IN others|NNS .|. 

These|DT are|VBP the|DT attributes|NNS we|PRP want|VBP all|DT children|NNS to|TO have|VB .|. 
You|PRP help|VBP Jameson|NNP campers|NNS reach|VBP for|IN them|PRP .|. 
If|IN these|DT special|JJ children|NNS are|VBP to|TO become|VB the|DT adults|NNS we|PRP all|DT need|VBP them|PRP to|TO be|VB ,|, we|PRP have|VBP to|TO lead|VB them|PRP in|IN the|DT right|JJ direction|NN right|RB now|RB .|. 

Jameson|NNP points|VBZ the|DT way|NN for|IN children|NNS who|WP need|NN that|IN extra|JJ hand|NN and|CC I|PRP hope|VBP you|PRP 'll|MD continue|VB your|PRP$ support|NN this|DT year|NN .|. 
You|PRP 're|VBP last|JJ gift|NN of|IN $50.00|NN helped|VBD make|VB it|PRP possible|JJ for|IN us|PRP to|TO provide|VB guidance|NN ,|, encouragement|NN and|CC fun|NN to|TO nearly|RB 400|CD Indianapolis|NNP area|NN children|NNS .|. 
And|CC not|RB just|RB during|IN the|DT summer|NN ,|, but|CC throughout|IN the|DT year|NN .|. 

What|WP has|VBZ your|PRP$ support|NN of|IN our|PRP$ campers|NNS meant|VBN to|TO them|PRP and|CC what|WP have|VBP they|PRP been|VBN able|JJ to|TO accomplish|VB because|IN you|PRP care|VBP ?|. 

The|DT best|JJS indicator|NN I|PRP can|MD give|VB you|PRP of|IN the|DT positive|JJ effect|NN our|PRP$ year-round|JJ contact|NN has|VBZ is|VBZ the|DT growth|NN in|IN and|CC deeds|NNS of|IN the|DT Youth|NNP Leadership|NNP teens|NNS .|. 
In|IN just|RB the|DT past|JJ few|JJ years|NNS this|DT program|NN has|VBZ grown|VBN from|IN a|DT few|JJ kids|NNS and|CC a|DT few|JJ extra|JJ activities|NNS to|TO a|DT team|NN of|IN almost|RB 60|CD young|JJ adults|NNS taking|VBG on|IN real|JJ projects|NNS .|. 
YL|NNP teens|NNS will|MD make|VB J.C.|NN juniors|NNS happen|VBP again|RB this|DT year|NN for|IN 7|CD and|CC 8|CD year|NN old|JJ campers|NNS .|. 
A|DT five|CD day|NN camp|NN ,|, J.C.|NN juniors|NNS introduces|VBZ at-risk|JJ children|NNS to|TO Jameson|NNP two|CD years|NNS earlier|RBR than|IN we|PRP could|MD previously|RB reach|VB them|PRP .|. 
That|DT means|VBZ we|PRP now|RB have|VBP the|DT opportunity|NN to|TO be|VB a|DT stable|JJ ,|, positive|JJ and|CC important|JJ part|NN of|IN each|DT child|NN 's|POS life|NN for|IN an|DT entire|JJ decade|NN .|. 

The|DT teens|NNS have|VBP also|RB decided|VBN to|TO raise|VB money|NN to|TO provide|VB camperships|NNS for|IN other|JJ campers|NNS because|IN they|PRP know|VBP what|WP Jameson|NNP has|VBZ meant|VBN to|TO them|PRP .|. 
And|CC their|PRP$ activities|NNS are|VBP n't|RB isolated|VBN to|TO Jameson|NNP .|. 
The|DT teens|NNS have|VBP undertaken|VBN a|DT volunteer|NN project|NN to|TO regularly|RB visit|VB with|IN sick|JJ children|NNS at|IN a|DT local|JJ hospital|NN .|. 

Please|VB consider|VB renewing|VBG your|PRP$ gift|NN today|NN .|. 
The|DT kids|NNS need|VBP your|PRP$ leadership|NN now|RB more|RBR than|IN ever|RB .|. 
If|IN you|PRP can|MD increase|VB your|PRP$ last|JJ donation|NN ,|, we|PRP would|MD appreciate|VB that|DT show|NN of|IN support|NN for|IN the|DT campers|NNS and|CC their|PRP$ efforts|NNS to|TO overcome|VB obstacles|NNS and|CC create|VB successful|JJ lives|NNS .|. 

Thank|VB you|PRP again|RB for|IN helping|VBG point|NN the|DT way|NN .|. 

Sincerely|NNP ,|, 

Julie|NNP Marsh|NNP ,|, Executive|NNP Director|NNP 

P.S.|NN 
You|PRP make|VBP it|PRP possible|JJ for|IN us|PRP to|TO help|VB special|JJ kids|NNS with|IN learning|VBG disabilities|NNS ,|, behavior|NN problems|NNS and|CC economic|JJ disadvantages|NNS to|TO gain|VB the|DT confidence|NN required|VBN to|TO put|VB genuine|JJ effort|NN into|IN achieving|VBG real|JJ goals|NNS .|. 
I|PRP hope|VBP you|PRP 'll|MD continue|VB -|: -|: and|CC if|IN possible|JJ increase|NN -|: your|PRP$ support|NN for|IN these|DT great|JJ kids|NNS .|. 

