July|NNP 30|CD ,|, 1999|CD 

Dear|RB Name|NN :|: 

Question|NNP What|WP do|VBP you|PRP get|VBP in|IN 987,165|CD hours|NNS with|IN 291|CD people|NNS in|IN 15|CD locations|NNS ?|. 

Answer|NNP 34,700|CD opportunities|NNS to|TO change|VB a|DT life|NN !|. 

This|DT is|VBZ exactly|RB what|WP happened|VBD in|IN 1997|CD when|WRB Community|NNP Centers|NNPS of|IN Indianapolis|NNP provided|VBD its|PRP$ comprehensive|JJ ,|, neighborhood-based|JJ services|NNS to|TO individuals|NNS and|CC families|NNS all|DT over|IN Marion|NNP County|NNP .|. 
And|CC we|PRP can|MD do|VB even|RB more|JJR in|IN 1999|CD with|IN your|PRP$ financial|JJ support|NN !|. 
Just|RB look|VB at|IN the|DT range|NN of|IN services|NNS we|PRP offer|VBP :|: 

70|CD ,|, 0001|CD career|NN assistance|NN for|IN youth|NN 
Preschool|NNP for|IN young|JJ children|NNS 
School|NNP Age|NNP Child|NNP Care|NNP for|IN and|CC children|NNS and|CC youth|NN 
Access|NNP services|NNS such|JJ as|IN emergency|NN and|CC holiday|NN assistance|NN for|IN all|DT ages|NNS 
Adult|NNP Day|NNP Care|NNP for|IN seniors|NNS 
Senior|NNP Case|NNP Management|NNP Aids|NNP Education|NNP for|IN youth|NN and|CC adults|NNS 
Senior|NNP Social|NNP Involvement|NNP Computer|NNP Training|NNP for|IN youth|NN ,|, adults|NNS and|CC seniors|NNS 
Senior|NNP Nutrition|NNP meal|NN program|NN 
Day|NNP Care|NNP for|IN young|JJ children|NNS 
Social|NNP Development|NNP and|CC Recreation|NNP for|IN children|NNS ,|, youth|NN and|CC adults|NNS .|. 
HIPPY|NNP (|( Home|NNP Instructional|NNP Program|NNP for|IN Preschool|NNP Youngsters|NNP )|) for|IN families|NNS .|. 
Stopover|NNP crises|NNS counseling|VBG for|IN youth|NN .|. 
In|IN Home|NNP Services|NNPS for|IN adults|NNS and|CC seniors|NNS .|. 
Transportation|NNP for|IN youth|NN and|CC seniors|NNS 

CCI|NNP is|VBZ a|DT federation|NN of|IN 13|CD neighborhood-based|JJ multi-service|JJ centers|NNS (|( plus|CC one|CD affiliate|NN )|) whose|WP$ mission|NN is|VBZ to|TO identify|VB and|CC meet|VB the|DT human|JJ service|NN needs|NNS of|IN the|DT greater|JJR Indianapolis|NNP community|NN in|IN the|DT most|RBS effective|JJ ,|, efficient|JJ and|CC comprehensive|JJ way|NN possible|JJ .|. 
Better|NNP yet|RB ,|, most|JJS of|IN these|DT services|NNS occur|VBP in|IN cooperation|NN with|IN private|JJ and|CC public|JJ agencies|NNS from|IN all|DT over|IN the|DT city|NN -|: CICOA|NNP The|DT Access|NNP Network|NNP ,|, Goodwill|NNP Industries|NNPS ,|, Indianapolis|NNP Housing|NNP Agency|NNP ,|, City|NNP of|IN Indianapolis|NNP ,|, Indianapolis|NNP Private|NNP Industry|NNP Council|NNP ,|, Family|NNP and|CC Social|NNP Services|NNPS administration|NN ,|, OTC|NNP ,|, Indy|NNP Parks|NNP ,|, and|CC numerous|JJ community|NN development|NN corporations|NNS ,|, neighborhood|NN organizations|NNS ,|, and|CC churches|NNS ,|, to|TO name|VB just|RB a|DT few|JJ .|. 

More|JJR than|IN 34,000|CD people|NNS benefited|VBD from|IN our|PRP$ services|NNS in|IN 1997|CD ,|, and|CC the|DT final|JJ count|NN for|IN 1998|CD could|MD be|VB even|RB higher|JJR .|. 
We|PRP 're|VBP asking|VBG for|IN a|DT contribution|NN in|IN the|DT amount|NN of|IN because|IN you|PRP ca|MD n't|RB got|VB a|DT better|JJR bang|NN for|IN your|PRP$ buck|NN than|IN to|TO support|VB an|DT organization|NN that|IN impacts|NNS so|RB many|JJ lives|NNS in|IN so|RB many|JJ ways|NNS .|. 
Your|PRP$ gift|NN will|MD enable|VB CCI|NNP to|TO provide|VB these|DT and|CC other|JJ necessary|JJ services|NNS at|IN a|DT neighborhood|NN level|NN ,|, face-to-face|JJ ,|, where|WRB it|PRP counts|VBZ .|. 

Please|VB ,|, make|VBP a|DT tax|NN deductible|JJ gift|NN to|TO Community|NNP Centers|NNPS of|IN Indianapolis|NNP in|IN 1999|CD ,|, and|CC know|VB that|IN COMPANY|NNP is|VBZ playing|VBG an|DT important|JJ part|NN in|IN meeting|VBG the|DT needs|NNS of|IN its|PRP$ community|NN .|. 
If|IN you|PRP have|VBP any|DT questions|NNS ,|, please|VB feel|VBP free|JJ to|TO give|VB us|PRP a|DT call|NN at|IN 638|CD -|: 3360|CD .|. 
We|PRP thank|VBP you|PRP for|IN your|PRP$ consideration|NN ,|, and|CC look|VB forward|RB to|TO hearing|NN from|IN you|PRP .|. 

Sincerely|NNP ,|, 

Earline|NNP S.|NN Moore|NNP President|NNP 

Valery|NNP De|NNP Long|NNP Director|NNP of|IN Development|NNP 

