AT&T|NNP 
ClassicGoldPlatinum|NNP 


Dear|RB Cardmember|NNP :|: 


Were|VBD pleased|VBN to|TO send|VB you|PRP the|DT enclosed|VBN AT&T|NNP Universal|NNP Card|NNP to|TO replace|VB your|PRP$ current|JJ card|NN .|. 
Please|VB destroy|VB your|PRP$ old|JJ card|NN and|CC begin|VB using|VBG your|PRP$ new|JJ card|NN as|IN of|IN the|DT “|NN valid|JJ date|NN ”|NN printed|VBN on|IN your|PRP$ new|JJ card|NN .|. 
Please|VB see|VB your|PRP$ card|NN carrier|NN for|IN additional|JJ information|NN and|CC instructions|NNS .|. 


Delivering|NNP your|PRP$ new|JJ card|NN gives|VBZ us|PRP an|DT opportunity|NN to|TO remind|VB you|PRP how|WRB we|PRP ’re|VBP delivering|VBG more|JJR ways|NNS to|TO make|VB your|PRP$ card|NN more|RBR useful|JJ .|. 
We|PRP ’ve|VBP made|VBD your|PRP$ card|NN easier|JJR to|TO use|VB with|IN features|NNS you|PRP can|MD customize|NN yourself|PRP …|NN more|RBR valuable|JJ with|IN special|JJ savings|NNS programs|NNS .|. 


Convenience|JJ features|NNS 

·|NN AT&T|NNP Calling|VBG Card|NNP feature|NN Use|NN your|PRP$ card|NN to|TO make|VB local|JJ ,|, long|JJ distance|NN ,|, even|RB international|JJ calls|NNS from|IN virtually|RB any|DT phone|NN .|. 
Simply|RB dial|NN 1|CD 800|CD CALL|NNP ATT|NNP ®|NN and|CC follow|VB the|DT recorded|JJ instructions|NNS .|. 


·|NN Account|NNP Online|NNP View|NNP your|PRP$ statement|NN ,|, see|VB unbilled|JJ activity|NN or|CC pay|VB your|PRP$ bill|NN on|IN the|DT Internet|NN .|. 
Look|VB for|IN the|DT Instant|NNP Access|NNP Code|NNP on|IN your|PRP$ statement|NN ,|, then|RB go|VB to|TO www.universalcard.com|NN and|CC follow|VB the|DT instructions|NNS .|. 


·|NN AutoPay|NNP EFT|NNP Payments|NNS Skip|NNP writing|VBG checks|NNS and|CC have|VBP your|PRP$ payment|NN made|VBN electronically|RB from|IN your|PRP$ bank|NN account|NN each|DT month|NN .|. 
Enroll|NNP on|IN Internetor|NNP call|NN Customer|NN Service|NNP for|IN details|NNS .|. 


Personalized|NNP features|NNS 

·|NN Cycle|NNP Date|NN You|PRP can|MD time|VB your|PRP$ statement|NN and|CC payments|NNS to|TO coincide|VB with|IN convenient|JJ times|NNS of|IN the|DT month|NN by|IN choosing|VBG your|PRP$ billing|NN cycle|NN date|NN .|. 


·|NN Personal|NNP Identification|NNP Number|NNP (|( PIN|NNP )|) Choose|VB your|PRP$ own|JJ PIN|NNP to|TO use|VB for|IN cash|NN access|NN and|CC calling|VBG .|. 


·|NN Calling|VBG Card|NNP Number|NNP Choose|VB your|PRP$ own|JJ calling|NN card|NN number|NN too|RB ,|, to|TO make|VB calling|VBG easier|JJR .|. 


Save|VB on|IN calls|VBZ with|IN the|DT AT&T|NNP One|CD Rate|NNP Calling|VBG Card|NNP Plan|NNP .|. 


If|IN you|PRP haven|NN ’|NN t|NN already|RB enrolled|VBD ,|, sign|NN up|RP for|IN this|DT plan|NN that|WDT saves|VBZ you|PRP money|NN on|IN your|PRP$ AT&T|NNP Universal|NNP Card|NNP calls|VBZ .|. 
You|PRP get|VBP the|DT low|JJ rate|NN of|IN 25|CD cents|NNS a|DT minute|NN anytime|RB ,|, anywhere|RB in|IN the|DT U.S.|NNP on|IN all|DT your|PRP$ AT&T|NNP Universal|NNP Card|NNP calls|VBZ when|WRB you|PRP make|VBP the|DT call|NN yourself|PRP by|IN dialing|VBG 1|CD 800|CD CALL|NNP ATT|NNP .|. 
To|TO enroll|VB ,|, call|NN 1|CD 800|CD 741|CD -|: 9302|CD .|. 
The|DT low|NN ,|, $1|NN monthly|JJ access|NN fee|NN will|MD be|VB conveniently|RB billed|VBN to|TO your|PRP$ account|NN .|. 


For|IN more|JJR information|NN on|IN any|DT of|IN these|DT features|NNS ,|, call|NN us|PRP at|IN 1|CD 800|CD 423|CD -|: 4343|CD .|. 
Thank|VB you|PRP for|IN carrying|VBG the|DT AT&T|NNP Universal|NNP Card|NNP .|. 
We|PRP look|VBP forward|RB to|TO continuing|VBG to|TO provide|VB you|PRP with|IN a|DT card|NN that|WDT grows|VBZ with|IN you|PRP through|IN the|DT years|NNS ahead|RB .|. 


Sincerely|NNP ,|, 



A|DT 
Mark|NNP Gilder|NNP 
Vice|NNP President|NNP ,|, Marketing|NNP 
Universal|NNP Card|NNP Services|NNPS Corp|NNP .|. 



Calls|NNS made|VBN from|IN payphones|NNS are|VBP subject|JJ to|TO a|DT surcharge|NN .|. 
AT&|NNP Ts|NNP surcharge|NN is|VBZ up|RB tp|NN $30|NN per|IN call|NN .|. 


20|CD %|NN POST|NNP CONSUMER|NN WASTE|NNP 

