NATIONAL|NNP WILDLIFE|NNP FEDERATION|NNP 
8925|CD Leesburg|NNP Pike|NNP 
Vienna|NNP ,|, VA|NNP 22184|CD -|: 0002|CD 
November|NNP 3|CD ,|, 2000|CD 
Dear|RB Friend|NNP of|IN Wildlife|NNP ,|, 

I|PRP hope|VBP you|PRP will|MD be|VB pleasantly|RB surprised|VBN --|: and|CC delighted|JJ --|: with|IN the|DT enclosed|VBN National|NNP Wildlife|NNP Wrapping|NNP Paper|NNP Collection|NNP and|CC matching|VBG gift|NN tags|NNS .|. 

They|PRP are|VBP our|PRP$ gift|NN to|TO you|PRP to|TO keep|VB and|CC use|VB on|IN your|PRP$ holiday|NN packages|NNS in|IN thanks|NNS for|IN considering|VBG this|DT important|JJ appeal|NN for|IN wildlife|NN .|. 

The|DT wrapping|VBG paper|NN and|CC matching|VBG gift|NN cards|NNS feature|VBP delightful|JJ holiday|NN wildlife|NN images|NNS that|WDT will|MD come|VB in|IN handy|JJ for|IN wrapping|VBG your|PRP$ last|JJ minute|NN presents|VBZ .|. 
These|DT images|NNS will|MD be|VB cheerful|JJ reminders|NNS to|TO you|PRP and|CC your|PRP$ gift|NN recipients|NNS of|IN all|PDT the|DT wildlife|NN treasures|NNS we|PRP value|VBP .|. 

During|IN this|DT holiday|NN season|NN ,|, we|PRP must|MD not|RB forget|VB the|DT wildlife|NN species|NNS that|WDT depend|VBP on|IN us|PRP for|IN their|PRP$ survival|NN .|. 
When|WRB you|PRP use|VBP the|DT attractive|JJ wrapping|NN paper|NN and|CC gift|NN tags|NNS ,|, you|PRP will|MD be|VB helping|VBG us|PRP spread|VBD the|DT word|NN about|IN saving|VBG America|NNP ’|NN s|VBZ wildlife|NN treasures|NNS and|CC their|PRP$ habitat|NN .|. 

While|IN you|PRP are|VBP under|IN no|DT obligation|NN for|IN these|DT small|JJ tokens|NNS of|IN appreciation|NN ,|, we|PRP do|VBP hope|VBP that|IN they|PRP will|MD remind|VB you|PRP to|TO do|VB your|PRP$ part|NN in|IN our|PRP$ conservation|NN effort|NN on|IN behalf|NN of|IN all|DT wildlife|NN and|CC wild|JJ places|NNS by|IN ...|... 
accepting|VBG this|DT special|JJ invitation|NN to|TO join|VB National|NNP Wildlife|NNP Federation|NNP as|IN our|PRP$ newest|JJS member|NN .|. 

I|PRP ’m|VBP sure|JJ you|PRP ’ve|VBP heard|VBN of|IN us|PRP either|DT directly|RB or|CC by|IN our|PRP$ publications|NNS and|CC activities|NNS .|. 
We|PRP are|VBP one|CD of|IN America|NNP ’|NN s|VBZ largest|JJS and|CC most|RBS successful|JJ conservation|NN and|CC education|NN groups|NNS .|. 
Ever|RB hear|VB of|IN Ranger|NNP Rick|NNP the|DT famous|JJ children|NNS ’|NN s|VBZ wildlife|NN magazine|NN ?|. 
That|DT ’s|VBZ us|PRP !|. 

Ranger|NNP Rick|NNP is|VBZ just|RB one|CD of|IN our|PRP$ many|JJ wildlife|NN publications|NNS .|. 
We|PRP also|RB publish|VB Your|PRP$ Big|NNP Backyard|NNP and|CC Wild|NNP Animal|NNP Baby|NNP .|. 
And|CC we|PRP ’re|VBP famous|JJ for|IN distributing|VBG the|DT one|CD magazine|NN in|IN America|NNP that|DT ’s|VBZ been|VBN called|VBN “|NN the|DT world|NN ’|NN s|VBZ most|RBS beautiful|JJ nature|NN magazine|NN ,|, ”|NN the|DT award-winning|JJ NATIONAL|NNP WILDLIFE|NNP .|. 

As|IN a|DT member|NN you|PRP ’ll|MD play|VBP a|DT role|NN in|IN educating|VBG millions|NNS of|IN Americans|NNPS —|NN young|JJ and|CC old|JJ alike|RB —|NN through|IN these|DT outstanding|JJ wildlife|NN publications|NNS and|CC many|JJ other|JJ related|VBN activities|NNS such|JJ as|IN distributing|VBG Wildlife|NNP Week|NNP materials|NNS to|TO millions|NNS of|IN American|JJ schoolchildren|NN each|DT year|NN .|. 

(|( over|IN ,|, please|VB ...|... )|) 

For|IN more|JJR than|IN 60|CD years|NNS ,|, caring|VBG and|CC concerned|VBN wildlife|NN lovers|NNS like|IN yourself|PRP have|VBP supported|VBN our|PRP$ mission|NN to|TO educate|VB ,|, inspire|VB and|CC assist|VB individuals|NNS and|CC organizations|NNS to|TO conserve|VB wildlife|NN and|CC other|JJ natural|JJ resources|NNS and|CC to|TO protect|VB the|DT earth|NN ’|NN s|VBZ environment|NN in|IN order|NN to|TO achieve|VB a|DT peaceful|JJ ,|, equitable|JJ and|CC sustainable|JJ future|NN .|. 
That|DT ’s|VBZ what|WP it|PRP ’s|VBZ all|DT about|IN securing|VBG a|DT place|NN for|IN wildlife|NN in|IN the|DT modern|JJ world|NN .|. 

Today|NN you|PRP have|VBP the|DT opportunity|NN to|TO join|VB this|DT successful|JJ cause|NN by|IN becoming|VBG a|DT member|NN of|IN NWF|NNP for|IN as|RB little|JJ as|IN $15|NN .|. 
Besides|IN having|VBG the|DT satisfaction|NN of|IN knowing|VBG that|IN you|PRP are|VBP doing|VBG your|PRP$ part|NN to|TO help|VB save|VB our|PRP$ wildlife|NN heritage|NN ,|, you|PRP will|MD also|RB receive|VB some|DT outstanding|JJ benefits|NNS of|IN membership|NN including|VBG :|: 
A|DT one-year|JJ subscription|NN to|TO our|PRP$ beautiful|JJ full|JJ color|NN magazine|NN ,|, NATIONAL|NNP WILDLIFE|NNP .|. 

Attractive|NNP wildlife|NN stamps|NNS ,|, calendars|NNS and|CC cards|NNS .|. 

An|DT official|JJ membership|NN card|NN and|CC decal|NN .|. 

Through|IN the|DT colorful|JJ pages|NNS of|IN NATIONAL|NNP WILDLIFE|NNP you|PRP will|MD be|VB fascinated|VBN by|IN exquisite|JJ photography|NN from|IN some|DT of|IN the|DT best|JJS nature|NN photographers|NNS in|IN the|DT world|NN .|. 
Our|PRP$ magazine|NN is|VBZ a|DT great|JJ way|NN to|TO stay|VB informed|VBN on|IN the|DT current|JJ issues|NNS affecting|VBG wildlife|NN and|CC see|VB what|WP NWF|NNP is|VBZ doing|VBG to|TO find|VB solutions|NNS to|TO these|DT problems|NNS .|. 
And|CC you|PRP ’ll|MD enjoy|VBP a|DT series|NN of|IN insightful|JJ stories|NNS on|IN a|DT variety|NN of|IN wildlife|NN species|NNS stories|NNS that|WDT can|MD ’|NN t|NN be|VB found|VBN anywhere|RB else|RB !|. 

As|IN an|DT added|VBN welcome|JJ gift|NN ,|, we|PRP will|MD send|VB you|PRP an|DT exclusive|JJ NWF|NNP tote|VB bag|NN .|. 
When|WRB you|PRP use|VBP it|PRP in|IN place|NN of|IN plastic|NN bags|NNS you|PRP help|VBP conserve|VB our|PRP$ natural|JJ resources|NNS .|. 
The|DT tote|VB bag|NN is|VBZ made|VBN of|IN a|DT strong|JJ ,|, cotton|NN material|NN and|CC has|VBZ plenty|NN of|IN room|NN ,|, including|VBG a|DT handy|JJ sewn-in|JJ pocket|NN .|. 
And|CC it|PRP ’s|VBZ a|DT great|JJ way|NN to|TO show|VB your|PRP$ commitment|NN to|TO conservation|NN every|DT day|NN .|. 

We|PRP are|VBP constantly|RB working|VBG in|IN every|DT part|NN of|IN the|DT country|NN to|TO save|VB those|DT species|NNS and|CC special|JJ places|NNS that|WDT are|VBP in|IN all|DT of|IN our|PRP$ minds|NNS .|. 
Here|RB are|VBP some|DT of|IN the|DT projects|NNS in|IN the|DT forefront|NN at|IN NWF|NNP right|RB now|RB :|: 

Working|NNP to|TO improve|VB the|DT water|NN quality|NN and|CC water|NN flow|NN in|IN the|DT Florida|NNP Everglades|NNS so|RB 
magnificent|JJ creatures|NNS like|IN the|DT gentle|JJ manatee|NN can|MD survive|VB .|. 

Reintroducing|NNP the|DT grizzly|RB bear|NN into|IN the|DT Selway-|NNP Bitterroot|NNP wilderness|NN area|NN of|IN Idaho|NNP 
and|CC Montana|NNP .|. 

Building|NNP on|IN our|PRP$ success|NN of|IN reintroducing|VBG the|DT gray|JJ wolves|NNS to|TO Yellowstone|NNP National|NNP 
Park|NNP by|IN expanding|VBG gray|JJ wolf|NN recovery|NN into|IN suitable|JJ habitat|NN in|IN the|DT United|NNP States|NNPS .|. 

Your|PRP$ gift|NN is|VBZ needed|VBN now|RB to|TO support|VB these|DT critical|JJ projects|NNS and|CC so|RB many|JJ others|NNS .|. 
Despite|IN our|PRP$ many|JJ victories|NNS ,|, we|PRP still|RB have|VBP far|RB to|TO go|VB to|TO ensure|VB a|DT healthy|JJ future|NN for|IN the|DT wildlife|NN and|CC wild|JJ places|NNS of|IN this|DT nation|NN .|. 
So|RB ,|, please|VB take|VB a|DT moment|NN right|RB now|RB and|CC become|VB a|DT member|NN of|IN NWF|NNP with|IN a|DT gift|NN of|IN only|RB $15|NN or|CC more|JJR .|. 
You|PRP will|MD be|VB making|VBG a|DT world|NN of|IN difference|NN in|IN helping|VBG us|PRP continue|VBP to|TO fight|VB for|IN the|DT species|NNS that|WDT can|MD ’|NN t|NN fight|NN for|IN themselves|PRP .|. 

Appreciatively|NNP ,|, 
Tom|NNP McGuire|NNP 
Vice|NNP President|NNP ,|, Membership|NNP Programs|NNP 

P.S.|NN Please|VB use|NN the|DT enclosed|JJ holiday|NN gift|NN wrapping|VBG paper|NN and|CC gift|NN tags|NNS to|TO help|VB spread|VB the|DT word|NN about|IN our|PRP$ mission|NN of|IN conservation|NN to|TO your|PRP$ friends|NNS and|CC family|NN .|. 
Don|NNP ’|NN t|NN forget|VB ,|, we|PRP will|MD also|RB send|VB you|PRP the|DT NWF|NNP tote|VB bag|NN with|IN your|PRP$ welcome|JJ package|NN when|WRB we|PRP receive|VBP your|PRP$ membership|NN gift|NN .|. 
Thank|VB you|PRP !|. 

