December|NNP 2000|CD 
Name|NN 
Address|NNP 
New|NNP York|NNP ,|, NY|NNP 10009|CD 
Earn|NNP up|IN to|TO 15,000|CD Mileage|NNP Plus|NNP ®|NN bonus|NN miles|NNS on|IN your|PRP$ choice|NN of|IN cruises|NNS !|. 

Dear|RB Name|NN :|: 

Great|NNP destinations|NNS ,|, your|PRP$ choice|NN of|IN itineraries|NNS ,|, big|JJ bonus|NN miles|NNS ,|, and|CC 3rd|CD and|CC 4th|JJ passengers|NNS cruise|VBP FREE|NN —|NN now|RB sailing|NN away|RB with|IN Renaissance|NNP Cruises|NNP is|VBZ more|RBR rewarding|JJ than|IN ever|RB .|. 
But|CC see|VB for|IN yourself|PRP ,|, because|IN 
these|DT special|JJ rates|NNS are|VBP available|JJ only|RB through|IN January|NNP 7|CD ,|, 2001|CD !|. 

Renaissance|NNP Cruises|NNP vacations|NNS escort|NN you|PRP from|IN one|CD fabulous|JJ destination|NN to|TO the|DT next|JJ in|IN a|DT beautiful|JJ cabin|NN aboard|IN a|DT brand-new|JJ ship|NN .|. 
You|PRP ’ll|MD enjoy|VB four|CD outstanding|JJ restaurants|NNS ,|, nightly|JJ entertainment|NN ,|, an|DT exciting|JJ casino|NN ,|, a|DT fitness|NN center|NN and|CC world-class|JJ spa|NN —|NN and|CC more|JJR !|. 
Optional|NNP shore|VB excursions|NNS will|MD provide|VB the|DT best|JJS opportunities|NNS for|IN exploring|VBG the|DT highlights|NNS of|IN each|DT fascinating|JJ port-of-call|JJ !|. 

This|DT great|JJ offer|NN is|VBZ available|JJ on|IN select|VB sail|NN dates|NNS from|IN January|NNP through|IN March|NNP 2001|CD ,|, you|PRP can|MD sail|NN between|IN Istanbul|NNP and|CC Barcelona|NNP ,|, Rome|NNP and|CC Athens|NNP ,|, or|CC Athens|NNP and|CC Istanbul|NNP .|. 
Just|RB look|VB at|IN these|DT great|JJ itineraries|NNS !|. 
Cruise|NN rates|NNS start|VBP as|RB low|JJ as|IN $599|NN for|IN an|DT outside|JJ cabin|NN on|IN select|VB sail|NN dates|NNS ,|, and|CC all|DT offer|NN the|DT option|NN of|IN your|PRP$ 3|CD rdr|NN and|CC 4th|JJ passengers|NNS cruising|VBG free|JJ !|. 

Select|NNP the|DT itinerary|NN that|IN piques|NNS your|PRP$ interest|NN ,|, and|CC call|NN On-Call|NNP Travel|NNP Services|NNPS to|TO reserve|VB your|PRP$ cabin|NN .|. 
Specify|NNP UWAX5|NNP to|TO receive|VB this|DT offer|NN .|. 
Low|NNP international|JJ airfare|NN is|VBZ also|RB available|JJ .|. 
Offer|NN is|VBZ first-come|JJ ,|, first-served|JJ and|CC at|IN this|DT incredibly|RB low|JJ rate|NN ,|, cabins|NNS are|VBP sure|JJ to|TO sell|VB out|IN quickly|RB ,|, so|RB call|NN 1-800-822-2841|NN today|NN !|. 

Sincerely|NNP ,|, 
Jack|NNP Mercer|NNP 
Silver|NNP Wings|NNP Plus|NNP Cruise|NNP Desk|NNP 

Price|NNP shown|VBN is|VBZ for|IN an|DT outside|JJ cabin|NN on|IN select|VB sail|NN dates|NNS and|CC new|JJ bookings|NNS only|RB .|. 
Price|NNP is|VBZ per|IN person|NN ,|, based|VBN on|IN double|JJ occupancy|NN ,|, for|IN cruise|NN only|RB ,|, may|MD vary|VB by|IN sail|NN date|NN ,|, and|CC requires|VBZ full|JJ payment|NN at|IN the|DT time|NN of|IN purchase|NN .|. 
Offer|NN is|VBZ subject|JJ to|TO availability|NN and|CC is|VBZ not|RB combinable|JJ with|IN other|JJ offers|NNS ,|, cabins|NNS may|MD sell|VB out|IN before|IN offer|NN expires|VBZ on|IN 1/7/01|CD .|. 
Cancellation|NNP fees|NNS may|MD apply|VB .|. 
All|DT schedules|NNS and|CC itineraries|NNS are|VBP subject|JJ to|TO change|VB .|. 
Government|NN tees|NNS and|CC charges|NNS for|IN all|DT passengers|NNS are|VBP additional|JJ .|. 
All|DT guests|NNS are|VBP subject|JJ to|TO the|DT terms|NNS and|CC conditions|NNS of|IN Renaissance|NNP cruises|NNS ’|NN Passage|NNP contract|NN ,|, available|JJ upon|IN request|NN .|. 
Bonus|NNP miles|NNS are|VBP per|IN cabin|NN and|CC will|MD be|VB credited|VBN within|IN 8|CD weeks|NNS of|IN sailing|NN .|. 
Mileage|NNP Plus|NNP account|NN number|NN must|MD be|VB provided|VBN at|IN time|NN of|IN booking|NN .|. 

