December|NNP 7|CD ,|, 2000|CD 
FirstName|NNP LastName|NNP 
StreetNumber|NNP StreetName|NNP ,|, 
CityName|NNP ,|, StateName|NNP ,|, ZipCode|NNP 
Dear|RB Friend|NNP ,|, 

As|IN a|DT member|NN of|IN World|NNP Wildlife|NNP Fund|NNP ,|, you|PRP know|VBP that|IN our|PRP$ efforts|NNS are|VBP essential|JJ to|TO preserving|VBG the|DT astonishing|JJ ,|, yet|RB desperately|RB threatened|VBN diversity|NN of|IN life|NN here|RB on|IN Earth|NNP .|. 

I|PRP ’m|VBP also|RB hoping|VBG you|PRP know|VBP that|IN you|PRP play|VBP a|DT vital|JJ role|NN in|IN achieving|VBG our|PRP$ conservation|NN goals|NNS around|IN the|DT globe|NN .|. 

That’s|DT why|WRB I|PRP want|VBP to|TO extend|VB my|PRP$ appreciation|NN for|IN your|PRP$ last|JJ membership|NN contribution|NN of|IN $500|NN .|. 
And|CC why|WRB I|PRP ’m|VBP writing|VBG you|PRP today|NN to|TO ask|VB you|PRP to|TO renew|VB your|PRP$ support|NN for|IN the|DT pivotal|JJ year|NN ahead|RB .|. 

In|IN fact|NN ,|, I|PRP want|VBP to|TO urge|VB you|PRP to|TO strengthen|VB your|PRP$ dedication|NN to|TO saving|VBG life|NN on|IN Earth|NNP —|: by|IN sending|VBG a|DT generous|JJ leadership|NN gift|NN of|IN $750|NN and|CC becoming|VBG a|DT member|NN of|IN World|NNP Wildlife|NNP Funds|NNPS prestigious|JJ Living|VBG Planet|NNP Society|NNP .|. 

With|IN your|PRP$ increased|JJ commitment|NN ,|, we|PRP can|MD move|VB forward|RB to|TO thwart|VB the|DT most|RBS serious|JJ threats|NNS to|TO endangered|VBN ecosystems|NNS .|. 
After|IN all|DT ,|, conservation|NN begins|VBZ with|IN saving|VBG those|DT at-risk|JJ places|NNS -—|: our|PRP$ forests|NNS and|CC deserts|NNS ,|, wetlands|NNS and|CC oceans|NNS ,|, mangroves|NNS and|CC coral|NN reefs|NNS —|: that|WDT provide|VBP a|DT lifeline|NN for|IN precious|JJ animals|NNS and|CC plants|NNS .|. 

To|TO this|DT end|NN ,|, we|PRP ’ve|VBP designated|VBN some|DT 200|CD ecoregions|NNS ,|, those|DT with|IN the|DT most|RBS outstanding|JJ and|CC diverse|JJ habitats|NNS ,|, as|IN our|PRP$ Global|NNP 200|CD .|. 
We|PRP ’re|VBP now|RB creating|VBG model|NN projects|NNS in|IN 25|CD of|IN these|DT high-priority|JJ areas|NNS --|: in|IN order|NN to|TO balance|VB conservation|NN with|IN people’s|NNS need|VBP to|TO use|VB natural|JJ resources|NNS to|TO sustain|VB their|PRP$ livelihoods|NNS .|. 

With|IN your|PRP$ increased|JJ commitment|NN ,|, we|PRP can|MD intensify|VB our|PRP$ campaigns|NNS to|TO protect|VB species|NNS that|WDT are|VBP in|IN grave|JJ peril|NN by|IN both|DT the|DT loss|NN of|IN habitat|NN and|CC the|DT illegal|JJ trading|NN in|IN animal|NN parts|NNS .|. 

Quite|RB simply|RB ,|, WWF|NNP must|MD do|VB even|RB more|JJR to|TO safeguard|VB the|DT tigers|NNS ,|, rhinos|NNS ,|, pandas|NNS .|. whales|NNS ,|, and|CC other|JJ creatures|NNS that|WDT still|RB remain|VB in|IN the|DT wild|JJ .|. 
While|IN we|PRP still|RB have|VBP the|DT chance|NN .|. 

So|RB in|IN addition|NN to|TO our|PRP$ efforts|NNS to|TO conserve|VB wildlife|NN preserves|VBZ ,|, we|PRP ’ll|MD escalate|VB our|PRP$ trailblazing|JJ program|NN to|TO find|VB alternatives|NNS for|IN traditional|JJ tiger-based|JJ medicines|NNS ...|. rescue|NN more|JJR rhinos|NNS in|IN Kenya|NNP and|CC Nepal|NNP through|IN our|PRP$ ambitious|JJ translocation|NN projects|NNS ...|... complete|VB the|DT first|JJ survey|NN of|IN China’s|PRP$ pandas|NNS in|IN over|IN a|DT decade|NN ...|. and|CC fight|NN to|TO halt|VB all|DT commercial|JJ whaling|VBG ,|, as|RB well|RB as|IN the|DT whale|NN meat|NN trade|NN .|. 

We|PRP ’ll|MD also|RB award|NN more|RBR small|JJ grants|NNS through|IN our|PRP$ Species|NNP Action|NNP Fund|NNP to|TO help|VB a|DT wide|JJ range|NN of|IN animals|NNS ,|, including|VBG whooping|JJ cranes|NNS ,|, giant|JJ river|NN otters|NNS ,|, and|CC Tibetan|NNP antelopes|NNS .|. 

And|CC with|IN your|PRP$ increased|JJ commitment|NN ,|, we|PRP can|MD battle|VB against|IN destructive|JJ global|JJ forces|NNS that|WDT transcend|NN regional|JJ and|CC national|JJ boundaries|NNS .|. 
Overfishing|NN ,|, deforestation|NN ,|, climate|NN change|NN ,|, and|CC the|DT proliferation|NN of|IN toxic|JJ chemicals|NNS top|VB the|DT list|NN .|. 

For|IN instance|NN ,|, our|PRP$ innovative|JJ “|NN Forests|NNP for|IN Life|NNP Campaign|NNP ”|NN establishes|VBZ an|DT international|JJ network|NN of|IN parks|NNS and|CC reserves|NNS .|. 
This|DT will|MD protect|VB at|IN least|JJS 10|CD %|NN of|IN each|DT different|JJ type|NN of|IN forest|NN found|VBD in|IN every|DT country|NN .|. 
Another|DT WWF|NNP goal|NN ?|. 
To|TO end|VB government|NN subsidies|NNS that|WDT promote|VBP overfishing|VBG and|CC to|TO encourage|VB new|JJ markets|NNS for|IN sustainably|RB managed|VBN fisheries|NNS .|. 

The|DT challenges|NNS we|PRP face|VBP are|VBP daunting|JJ ,|, to|TO be|VB sure|JJ .|. 
However|RB ,|, I|PRP ’m|VBP confident|JJ that|IN by|IN joining|VBG together|RB again|RB ,|, we|PRP can|MD make|VB exciting|JJ progress|NN in|IN the|DT year|NN ahead|RB .|. 
I|PRP want|VBP to|TO ask|VB you|PRP ,|, therefore|RB ,|, to|TO renew|VB your|PRP$ valued|VBN World|NNP Wildlife|NNP Fund|NNP membership|NN and|CC ,|, hopefully|RB ,|, at|IN the|DT Living|VBG Planet|NNP Society|NNP level|NN of|IN $750|NN .|. 

When|WRB you|PRP do|VBP ,|, you|PRP ’ll|MD extend|VB your|PRP$ commitment|NN as|IN an|DT esteemed|JJ partner|NN with|IN WWF|NNP --|: the|DT largest|JJS and|CC most|RBS effective|JJ international|JJ conservation|NN group|NN in|IN existence|NN .|. 

Now|RB ,|, with|IN your|PRP$ increased|JJ commitment|NN ,|, we|PRP can|MD save|VB more|JJR of|IN our|PRP$ planet’s|NN cherished|VBN wild|JJ species|NNS and|CC their|PRP$ irreplaceable|JJ habitats|NNS ...|. as|IN we|PRP strive|VBP to|TO ensure|VB a|DT healthy|JJ and|CC thriving|VBG future|NN for|IN our|PRP$ extraordinary|JJ natural|JJ world|NN .|. 

Once|RB again|RB ,|, please|VB accept|VB my|PRP$ warmest|NN gratitude|NN for|IN your|PRP$ past|JJ support|NN And|CC please|VB ,|, take|VBP a|DT moment|NN today|NN to|TO renew|VB your|PRP$ critically|RB important|JJ WWF|NNP annual|JJ membership|NN .|. 
Thank|VB you|PRP .|. 

Sincerely|NNP ,|, 
Kathryn|NNP S.|NN Fuller|NNP 
President|NNP 

P.S.|NN As|IN a|DT Living|VBG Planet|NNP Society|NNP member|NN ,|, you|PRP ’ll|MD receive|VBP the|DT wonderful|JJ array|NN of|IN benefits|NNS described|VBD in|IN the|DT enclosed|JJ brochure|NN .|. 
Plus|NNP ,|, to|TO acknowledge|VB your|PRP$ increased|JJ gift|NN of|IN $750|NN ,|, we|PRP ’ll|MD send|VB you|PRP a|DT free|JJ copy|NN of|IN our|PRP$ stunning|JJ coffee-table|JJ photography|NN book|NN ,|, Living|VBG Planet|NNP Preserving|NNP Edens|NNP of|IN the|DT Earth|NNP .|. 
Please|VB let|VB it|PRP be|VB a|DT constant|JJ reminder|NN of|IN all|DT you|PRP ’re|VBP doing|VBG to|TO preserve|VB our|PRP$ endangered|JJ wildlife|NN !|. 

